%%%%%%%%%%%%%%%%%%%%%%%%%%%%%%%
%.   .   .   .    .       %  G%
% .   .   .   .               %
%  .   .   .   .             G%
%P  .   .   .   .             %
%%%%%%%%%%%%%%%%%%%%%%%%%%%%%%%
